,total,cat1,cat2,cat3,cat4,cat5,cat6
1st,25,21,4,0,0,0,0
2nd,58,56,2,0,0,0,0
3rd,66,63,3,0,0,0,0
4th,45,40,5,0,0,0,0
5th,31,29,2,0,0,0,0
6th,8,7,1,0,0,0,0
7th,1,1,0,0,0,0,0
8th,0,0,0,0,0,0,0
9th,4,3,1,0,0,0,0
10th,0,0,0,0,0,0,0
11th,1,1,0,0,0,0,0
12th,1,1,0,0,0,0,0
13th,0,0,0,0,0,0,0
14th,0,0,0,0,0,0,0
15th,0,0,0,0,0,0,0
placed,240,222,18,0,0,0,0
not_placed,0,0,0,0,0,0,0
total,240,222,18,0,0,0,0
